DATE,TRANSACTION_ID,REMARKS,DEBITED,CREDITED,CR_BALANCE
21/06/2020 23:34:3.676,0000000000000000000,initialization,00,00,00
2021-06-18 14:53:17.163742,c9cb9c99cf5d4925aa82aaec74fa9691,testing account deposit,0.0,100,100.0
2021-06-18 15:43:00.964298,c18659942ee8459cac494f46743b1b9b,testing account deposit,0.0,100,200.0
2021-06-18 15:43:00.964298,ad2e3095db5a4958a47fc0e90ba70ec0,testing account withdrawl,20,0.0,180.0
2021-06-24 17:53:17.886815,053067e38a074cd68c5557d7bffa27c4,Self Deposit,0.0,150,330.0
2021-06-25 00:49:04.519728,c54fe301ef914fabb56a24475095a831,Self Deposit,0.0,150,480.0
